15,15,15,15,15,15,15,15,15,15,15,15,15,15,15,15,15,15,15,15,15,15,15,15,15,15,15,15
0,0,0,0,0,0,0,0,0,0,0,0,0,0,0,0,0,0,0,0,0,0,0,15,15,15,15,15
0,0,0,0,0,0,0,0,0,0,0,0,0,0,0,0,0,0,0,0,0,0,0,15,15,15,15,15
0,0,0,0,0,0,0,0,0,0,0,0,0,0,0,15,0,0,0,0,0,0,0,0,0,0,0,0
15,15,15,15,15,0,0,15,0,0,0,0,0,0,0,15,0,0,0,0,0,0,0,0,0,0,0,0
0,0,0,0,0,0,0,15,0,0,0,0,0,0,0,15,0,0,15,0,0,0,0,15,15,15,15,15
0,0,0,0,0,0,0,15,0,15,15,0,15,15,0,15,0,0,15,15,15,15,15,15,0,0,0,0
0,0,0,0,0,0,1,15,0,15,0,0,0,15,0,15,1,0,0,15,15,15,0,0,0,0,0,0
15,15,15,15,0,0,0,15,0,15,0,0,0,15,0,15,0,0,0,0,0,0,0,0,0,0,0,0
0,0,0,0,0,0,0,15,0,15,0,0,0,15,0,15,0,0,15,0,0,0,0,15,0,0,0,0
0,0,0,0,0,0,1,15,0,15,0,0,0,15,0,15,0,0,15,0,0,0,0,15,0,0,0,0
0,0,0,0,0,0,0,15,0,15,15,0,15,15,0,15,0,0,15,15,0,0,15,15,0,0,0,0
0,0,0,0,0,0,0,15,0,0,0,0,0,0,0,0,0,0,0,0,0,0,0,0,0,0,0,0
15,15,15,15,15,1,0,15,0,0,0,0,0,0,0,0,0,0,0,0,0,0,0,0,0,0,0,0
0,0,0,0,0,0,0,15,0,0,0,15,15,15,15,15,15,15,15,0,0,15,15,15,15,15,15,0
0,0,0,0,0,0,0,15,15,15,15,15,15,15,15,15,15,15,15,15,15,15,15,15,15,15,15,15
15,15,15,15,15,15,15,15,15,15,15,15,15,15,15,15,15,15,15,15,15,15,15,15,15,15,15,15
15,15,15,15,15,15,15,15,15,15,15,15,15,15,15,15,15,15,15,15,15,15,15,15,15,15,15,15
